0000000000000000000000000000000000
0000111111111111111111111111000000
0000111111111111111111111111000000
0000000011222222222222110000000000
0000000011222222222222110000000000
0000001111223333333322111100000000
0000001111223333333322111100000000
0000111111223344443322111111000000
0011111111223345543322111111111100
0011111111223345543322111111111100
0000111111223344443322111111000000
0000001111223333333322111100000000
0000001111223333333322111100000000
0000000011222222222222110000000000
0000000011222222222222110000000000
0000111111111111111111111111000000
0000111111111111111111111111000000
0000000000000000000000000000000000
