0000000000000000000000000000000000
0000000000000000000000000000000000
0000554433221100000011223344550000
0000554433221100000011223344550000
0000443322110011111100112233440000
0000443322110011221100112233440000
0000332211000000220000001122330000
0000332211000000110000001122330000
0000221100000011221100000011220000
0000221100000011221100000011220000
0000332211000000110000001122330000
0000332211000000220000001122330000
0000443322110011221100112233440000
0000443322110011111100112233440000
0000554433221100000011223344550000
0000554433221100000011223344550000
0000000000000000000000000000000000
0000000000000000000000000000000000