0000000000000000000000000000000000
0000004433221111111111112233440000
0000004433221111111111112233440000
0000000000112233344333221100000000
0000000000112233344333221100000000
0000000000000011222211000000000000
0000000000000011222211000000000000
0000001111112222222222221111110000
0000111111112333455433321111111100
0000111111112333455433321111111100
0000001111112222222222221111110000
0000000000000011222211000000000000
0000000000000011222211000000000000
0000000000112233344333221100000000
0000000000112233344333221100000000
0000004433221111111111112233440000
0000004433221111111111112233440000
0000000000000000000000000000000000
