0000000000000000220000000000000000
0000000000000033223300000000000000
0000000000003333003333000000000000
0000000000333300440033330000000000
0000001122330033443300332211000000
0000001122002233003322002211000000
0000110000112200000022110000110000
0000220000110000000000110000220000
1123443211001234444321001123443211
1123443211001234444321001123443211
0000220000110000000000110000220000
0000110000112200000022110000110000
0000001122002233003322002211000000
0000001122330033443300332211000000
0000000000333300440033330000000000
0000000000003333003333000000000000
0000000000000033223300000000000000
0000000000000000220000000000000000